comment	value	hate
네놈이 죽였으니 영원히 못잊겠지 돼지새끼 뻔뻔함 지리구요. 인간성 더러운거 오지구요.	personality	hate
저 자리에 니가 누워 있어야 되는건데 돼지 정은아.	appearance	offensive
비밀파티하고 술쳐먹고 죽은걸 누가보면 전쟁나가서 의사 한줄 알겟네 ㅋㅋㅋㅋㅋㅋㅋㅋㅋㅋㅋㅋㅋㅋㅋㅋㅋ그래봣자 다 빨갱이	none	offensive
"위선 쩌네... 지가 죽여놓고는 ""악어의 눈물""."	personality	hate
쑈하고 자빠젔네 모지리들 ㅋㅋㅋ ㅋ	none	hate
씨ll발 씹돼지 개정은아. 사람 좀 고만 죽여라 인간백정새끼	appearance	hate
지들끼리 권력투쟁하다 죽여놓고 쑈들 하고 자빠졌네. ㅉㅉ	none	offensive
쩡은이가 처맞아듸저야하는데	none	offensive
지가 죽여 놓고는 연기하고 자빠졌네	none	offensive
니가 죽인거 아니냐?	none	offensive
교통사고로 죽었는데 시체 존나 깨끗한거보소ㅋㅋ	none	offensive
정은아.. 니도 뒈지거라.. 족발 얹져줄게..	none	offensive
니 독감걸린걸.. 별걸다기사로 ㅉ	none	offensive
니 말뿐이잖아 구체적증거를 내놔 계좌이체했음 이체기록과 중고나라거래했음 거래기록	none	none
니 부모를위해 울어본적있냐? ㅉㅉㅉ 군대가면 다 뒤져서 오는줄아나	family	offensive
니 아부지가 염라언니였어 ㅍㅎㅎ	none	none
니 이미지가 악녀스럽지 ㅋㅋㅋㅋㅋ 엠빙신 연기대상때 한참어린 한효주랑 기싸움하는거 아직도 눈에 선하다 ㅋㅋㅋㅋㅋ	personality	hate
니가 그덯케 thㅏ움을 자래? 옥땅으로 올라와	none	offensive
니가 누구랑 사귀든 관심 없다 OOO년아 얼굴에 주사맞은년이 ㅋㅋ 에휴 역겨워	appearance	hate
니가 민폐인걸 지금알앗니??	personality	hate
니가 살찌는건 쳐먹고 운동을 안해서지	appearance	hate
니가 하는 짓거리가 딱 설리야 그 뒤를 이어서 골로 가버려라스케치북이나 올리는 짓을 하냐	none	hate
니놈이 실력이 있냐 외모가 출중하냐 호감형이길 하냐 키라도 크냐 천운으로 이름 좀 날렸다마는 부모 죄가 없어도 넌 연예계에 발 오래 못붙일 놈이었어 나혼자산다서 24시간이 모자라게 쳐먹는놈 띄워주는거 보고 박나래도 싫어질려고 하더라	grade	hate
니들 송혜교 욕하지말아라. 고소미 먹는다..저긴 캡쳐부대 좌표찍고 몰려오니깐 조심해야해. 똥이 더러워서 피하지 무서워서 피하냐? 미국같았으면 징역감인데말야..이래서 아직 한국이 후진국임.	personality	hate
니들 임신한것까지 알아야하냐	none	none
니보다 더 할까?	none	none
니키에 52킬로는 너무하지안나? 나도 170 에 53인데?	none	none
님이 구매해서 기부해주세요	none	none
다 고소미 먹어라 미친 ㅠ 진짜 원걸 골수팬 중에 선예 욕하는 사람 없어요 12년 팬하면서 선예 원망해본 적 없습니다 팬인척 하지 마세요 진짜 가소롭고 소르끼치네; 진짜 다들 경찰서에서 정모하시길^__^	none	offensive
다 넘 늙었다 상콤이들데려와쥬	none	none
다 늙어서 뭔 아이돌가수 득실거리는데서 버틸수 있겠냐?	grade	offensive
다 듣보잡 B급 연예인만 모아놨네ㅉㅉ 얼마 못가 망할듯	none	offensive
마약중독에 성형중독에... 휴	appearance	hate
마약한게 누군지가 중요한게 아닙니다. 사건의 본질을 봐주세요	none	none
마을끌어닷도 너무 어려서라 몰랐겠지만..열심히 활동해서 배로 갚아주세요! 이자까지요! 부모가 빚이 있으면 상속포기 안하면 자식에게 되물림됩니다..	none	none
마음고생 심했을텐데 무사히 잘 마쳤네요~여기 않좋은 말들이 많지만 조용히 응원하는 사람도 있답니다 잘쉬시고 다시 좋은 연기로 만나요 화이팅	none	none
마음고생은 뭔~ 걍 자연스레 지나갈 일이지. 진짜 뭔가가 없다면	grade	offensive
마음놓고 한댄다 하이고	none	none
마음도 몸도 아름다운 방탄소년단 지민이다!	none	none
마음이 아프네 독점술배우지말고 예수님 믿으세요	none	none
송중기 시대극은 믿고본다. 첫회 신선하고 좋았다.	none	none
지현우 나쁜놈	personality	offensive
알바쓰고많이만들면되지 돈욕심없으면골목식당왜나온겨 기댕기게나하고 산에가서팔어라	none	none
설마 ㅈ 현정 작가 아니지??	none	none
이미자씨 송혜교씨 돈이 그리 많으면 탈세말고 그돈으로 평소에 불우이웃에게 기부도 좀 하고사시죠.	none	none
아이즈원 힘내세요...일본 진출도 했으니 일본서 좋은 모습 보여줘도 팬들은 응원 합니다.	none	none
강부자 선생님 전미선 비보에 오열을 하셨다니 눈물이 나네요 힘내세요	none	none
알았어 그만	none	none
이영자씨는 진정성 있는거라면 녹화불참으로 끝내지말고 자진하차해라 시청자는 고려도 안하고 일방적 불참은 아닌듯 엠비씨도 시청율 좋아서 고민하는거 같은데 결방할게 아니고 폐지해라	grade	offensive
아c발 어쩌라고 뭔기사가계속나오냐	none	hate
진짜 멋지네요~	none	none
명수 응근슬쩍 뒷치기각잡네	none	offensive
철구한테 별풍쏜놈 수준도 똑같지 뭐 ㅋㅋ	grade	offensive
둘이 화장실가서 싸우길	none	none
기자왜이래? 이건 아니야 니 일기장에 써라 제목부터 오바야	grade	offensive
이거 아직도 하?	none	none
조우종이가 장성규보단 낫지~장성규 얼마못간다	none	none
난 남자쪽에서 여자를 버렸다는줄 알았는데 자세히 보니까 여자쪽 집에서 남자를 버린것 같은데... 버려놓고 이제와서?;;;	gender	offensive
언플 오지네 진짜 ! 언플하기전에 연기력과겸손함부터 쳐배워라 !	none	hate
한화이글스 해산하자!!! 丕빱♡	none	hate
유이 자연스러워진 연기	none	none
알겠으니까 이제는 좀 조용히좀 살아 진짜 관종이네ㅋㅋㅋㅋㅋㅋㅋㅋㅋㅋㅋㅋ	personality	hate
서현진 이민기 둘다 연기가 식상함	grade	offensive
왜 유재석에게는 얼굴에 케익폭탄인가 그 벌칙 안하는거지?	none	none
유승준은 천재적인 재능이라도 있지 이넘은 뭐없잖어 대중들이 왜 봐줘야해	grade	hate
왜 현우한테 ㅠㅜ	none	none
ㅋ 여기 댓글은 tv조선 직원들이 동원됐나여?	none	none
그래도 17 18 19회분은 보여주는게	none	none
남자는 애걸복걸한 여자를 좋아하지않는데 박나래도 알텐데 그냥 쇼맨쉽인가	gender	offensive
이승기 예능 이끌 능력도없는데 팬을위한프론가보네	grade	offensive
캡쳐할 인간들 수두룩이네ㅋㅋ	none	none
둘다 비교하면서 들어봤는데 곡의 장르 분위기만 비슷하다고 느낄수있는데 표절은 아니다...그냥 가수 목소리만 비슷하네 창법이 비슷해서 혼돈 할수도 있을듯...	none	none
지인들끼리 밥내기 골프정도는 안하나? 기레기 어떻게든 엮으려고 하네...	none	hate
꺼져주세요.. ㅈㄴ보기싫네	none	hate
스포츠예능에 약쟁이라니?	none	offensive
간이 덜컥 빠지는 소리. 컥 세종아 너만은 아니길.	none	none
듣보잡 이지만 축하	grade	hate
여자 두명이면 서로 까고 세명이면 둘이 하나깜	gender	hate
손예진이랑 소지섭이랑 곧 결혼한다 이글은 곧 성지글이 된다.	none	none
한혜진 진짜 성격은 모르겠고 방송이미지는 여자들이 좋아할 성격임 남자들이 볼땐 그냥 친구란 생각밖에 안들고 물론 좋은 성격인거 같긴함 방송 이미지대로라면	none	none
효녀라 좋았는데...혜나 미워하는 인간들은 뭐지!!	none	none
머리가 삼발이라 짜잖아서 보기싫다	appearance	hate
디패 추가공식입장내길바란다 저렇게 무성의하게 조작됐고 아는바없다만 올리지말고..내부든 외부든 누가조작했는지 밝혀내겠다 혼선드려 죄송하다 두사람에게 사과한다 등 내야하는거 아닌가	none	none
아니라자나!!! 아 놔 진짜 난 팬도 아닌데다 짜증나네 이것 말고 웟대가리들이나 파라고!!!	none	offensive
조금 헷갈리긴 하지만 자세히 들어보면 다 맞출 수 있던데..ㅎㅎ	none	none
마음이 아프네요ㅠ	none	none
"마음이 이뻐서 그런거 박명수는 나이들면서 관상이 더 좋아지는거 같아. 반면 유갈비,문재앙은 에휴 카악 퉤~"	grade	hate
마이크로 닷 뒤에com도 잡아왔냐?	none	hate
마이크로 닷이 무슨 죄냐?이제 떴는데 안타깝다.연예인으로 뜨는건 복권당첨과 비슷하다던데..안타깝다.	none	none
마이크로 음성변조하는거 다 티남 노잼	grade	hate
마이클잭슨 흉내내고..좀 이상하고 오글거리던데	personality	hate
마자 격주로 번갈아가면서 나와줬음 좋겠다 ㅜ 진심 ㅠ	none	none
"마지막에 남규리가 했던 again 해서 always 할 수도 있다는 말이.. 꼭 이루어졌으면 해요. 팬도 아니였는데, 셋이 함께 있는 모습에 눈물이 났어요."	none	none
마지막에 이승기 죽습니다	none	none
마취크림 바르는데...수면마취까지는 필요없어요	none	none
마흔이 요즘은 늦은 나이 아니예요힘내시고 몸 잘 추스리시길	none	none
막내딸이랑 기태영 잘어울린데 왜 난리들 ㅠ	none	none
막돼먹은영애씨 진짜 판박이!	none	none
막장 중에 막장 드라마. 이런 드라마를 보는게 더 이상한듯~ 짤방만 봐도 내용을 다 알겠네요.	none	offensive
막장도 너무 막장이더라. 주동민 같은 트렌디한 피디가 연출 안했다면 욕 엄청 먹었을 드라마 같네요. 피디가 아까움.	grade	offensive
만 17살이면 고3인데 2살차이나면 만날수도잇지	none	none
만약 진실이라면 맞고소 가능한ㅑ?	none	none
만진건 변하지 않는다 아이돌은 아이돌 좋아하는 여자들한테 이미지가 생명인데 얜 바닥쳤고 같이하는 멤버들도 끼리끼리로 보일듯ㅋㅋㅋㅋ	appearance	hate
만찬 둘이 과연 알콩달콩 할까? ㅋㅋ 상상만해도 너무좋다	none	none
많이 고쳤네ㅠ 싼티가 많이 났었는데 고친게 낫긴하군	appearance	hate
많이 고친녀 ㄴ	appearance	hate
많이 낳으면 또 많이 낳는다고 욕하잖아....하여간 진짜....남인생 오지랖들은....	none	none
많이 변했어용 주름 ㅠ 애들키우니깐	none	none
"많이 억울한 느낌 ,,힘들었나보다"	none	none
많이 힘들었을텐데 컴백해줘서 고마워♡	none	none
말 좀 생각해보고 해라 악플러들아 다 본인에게로 돌아간다	none	none
말로만 존경하지말고 실천해라 재동아 명수야	grade	offensive
말싸움하면 때려도되나? 여/남 4명/2명 단순비교로만 봐도 일방적인 폭행인데?	none	none
말이 크리에이터지 백수 아님?	grade	offensive
말투도 띠껍고 변한듯 다나 예쁜 사람 이었는데 뚱뚱해지고 이상해 진거 같다	appearance	hate
말투뷰터 아주 달달혀	none	none
말하는 수준이 좀 떨어지는 뇨자.	personality	hate
말할수록 매력이 없는 스타일.... ㅜ	none	none
맛난거 먹으러 메시야 가야겠다 사람 좀 줄었겠지 거품빠지고 차라리 잘됐다 현우 보고싶다	none	none
맛녀는 게스트나온화는 무조건거른다	none	none
맛좋은 산이 당신은 좀 짜져	personality	hate
망원동 옥탑방에 살다가 돈좀 벌고 옆에 마누라입김넣고 살만 해지니 슬슬 욕심이 생기나보네. 육중완. 남도 아닌 같은 팀 멤버들 가슴상처주고 넌 잘될꺼같지? 고스란히 너도 어려움 받을꺼다. 육 돈 밴드~~	none	hate
망작도 이런 망작이 읍던데	none	none
망할 조합에 망할 시나리오..	none	offensive
맞는 말 하긴 했는데ㅋㅋㅋㅋ 일본에서 말하는 바람에 디지게 쳐맞는 중	none	none
맞는말인데 ㅋㅋㅋ 전라디언들은 그들만의 세상에 살잖아?? 통수 잘치고 ㅋ	none	hate
맞벌이도 아닌데 뭐저렇게까지 아이를 봐야하나ㅠ	none	none
맞습니다. 자숙하시고 달라지 모습으로 나오시길 바랍니다.	none	none
"맞을 만한 ""사람""이란게 없는거지. 쟤들이 사람같아보임? 사람이라고 생각함?..."	none	hate
매니저 저렇게잘해주면부담스러워서 관둘듯 나중에관둘때도 좋게관둘거같지가않은디	none	none
매니저가 30번도 넘게 바뀐걸 보면 그닥 좋은 인성은 아닌듯한데 잘먹는다는 이유만으로 지덕체를 갖춘 인물이됨ㅋㅋㅋㅋ확실히 먹는데 한맺힌 민족답다	none	none
매니저님 볼때마다 성혁 생각남 장보리 문지상	none	none
매니저보려고 보는프로인데 매니저가 개성도없고 웃기지도않고... 크러쉬혼자 다하는거같음..	none	none
매력 쩐다	none	none
매력이 넘치는 배우...	none	none
매력이 없음	none	none
매번 논란과 해명의 반복이라......	none	none
매주 수요일 목요일만 기다립니다 작가님 감사합니다ㅜㅜ	none	none
매주봐도 고주원만한 비쥬얼이 연예인중에서도 흔치않다..정말 잘생겼다	none	none
매회 초반 채널을 돌리게한다. 시선을 붙드려 노력해도 모자랄판에 . 안타까워서 하는말. 시청자가 기다리는 장면으로 바로 내달릴수 없음?	none	none
맥락없는 드라마. 그래서 좋음ㅋㅋㅋㅋ	none	none
맨날 같은 스토리에 막장이 그러니 라이프온마스가 시청률 최고찍지 ㅡㅡ 공영방송국들아 언제까지 막장드라마 찍을까? 수신료아깝다 ㅡㅡ	grade	offensive
맨날 못생기고 더러운 기안 이시언 이딴 애들 보다가 황민현 나오니깐 눈정화 오졌다	appearance	hate
맨날 새벽 네다섯시에 피시방에 앉아서 노력은 안하고 신세한탄이낭하고있던데	grade	offensive
맨날. 맨날..건축학개론 왜. 올리는데 지긋지긋하다. 와그러는데 왜????.다른영화말고 와 건축학개론 언급하는데. 이쪽이서도 저쪽에서도 와그라노기자 뭐가 문제나???.	none	none
"맨날연예인 자살 뉴스나는데 드라마까지 자살이냐?이런건 방송에서 자제해야하는거 아닌가?작가, 피디부터 정신 차려야겠다.나는 이프로 한번도 안봤다. ㅋ"	none	hate
맨위에사진은 아오이츠카사닮게 나왔네요	none	none
맴버들 밥먹다 채하것다ㅋ	none	none
맴버좀 싹 바꿔라 이제 ㅡㅡ	none	none
머 말만하면 단독이냐 !! 그럼 혼자 단독으로 알고있어라	none	none
머 사진 찍는 자리까지 머라고 하는건지... 사진 찍을때 어디서 찍든 그게 무슨 상관임?? 자리에 최우수상 우수상 따로 있는것도 아니고.. 참 세상 힘들게들 사네...	none	none
머가리는 그대로네 ㅋㅋㅋㅋㅋㅋㅋ	none	offensive
머같은 프로그램이 배우하나 바보만드네....S방송사 예능은 이제 갈때까지 갔네..	none	none
머리 개안어울리네.. 동안페이스가 무슨 저런 머릴하냐 숏컷이 어울릴거같구만	appearance	hate
머리 좀 묶어 주셔요~~	none	none
머리. 누가 그렇게 해줬나요?? 이상해.	appearance	offensive
머리가 크네요	appearance	offensive
머리는 허전할까봐 있는지.. .	grade	hate
머리좀 저렇게 안했음 좋겠음 무슨 상투말은것도 아니구 왤케 꼴뵈기싫든지	appearance	hate
머리카락을 아프게 잡아당긴거임? 뭐땜에 그런거임? 성추행식으로 변태같이 머리만짐? 아 뭐 영상이 없으니 뭐가 잘못된건지 알수가있나	none	none
머리카락좀 묶어주라.. 애 덥겠다	none	none
머스마 인상이 않좋네	appearance	hate
머여 이 쓰레기는	none	hate
먹기 싫어도 쫌 밥좀 먹고 다녀라 너무 술 하고 담배 커피만 먹네 언능 쾌차하시길	none	none
먹방 보는 시청자 수준을 알겠다. 그냥 자기 맘에 안들면 작가도 물어뜯고 연기자도 물어뜯는 아주 질 나쁜 악질들이네.	none	hate
먹으면 바로 찌는 체질이군 난 아무리 먹어도 안찌는데	none	none
먹을거잘사주면 좋아합니다 사랑해 울조카님들	none	none
먼 매력에 끌렸는지 .. 그리 잘생긴 얼굴도 아닌데 하라가 넘 아까운디 ..	none	none
먼가 내용 점점 산으로 가는듯 처음의 신선함은 없어지고 질질 끄는 듯한 기분 보는 내내 폰 만지작 거렸어용	none	none
먼가 냄새가 나는데??로비??	none	none
먼가 아쉽다.안정환 안닮았어....하필 OOO 보리문둥이와..난 절라쌍도와는 절대 결혼안한다.본적까지 따져볼것	family	hate
먼기사를 기대하고 사진을 올리는지....관종	personality	hate
먼데 또?노잼이다	personality	hate
먼저 언론에 공개하고 인터뷰한사람이 구린 경우가 많지	none	none
멋있기만 하구만.이러다 헤어지면 헤어지는거지뭐.연예할때 맘껏 즐기는거 보기 좋은데.내숭보단 훨씬 낫다.화이팅!!	none	none
멋있는 여자라는 사람은 바로 김남주 배우님 같은 사람이구나하고 느꼈어요ㅠㅠ 앞으로 더 공정하고 투명한 연기로 또 팬들 앞에 나타나 주세요!!	none	none
멋있다 사람이 연애하면서 사는거지누구랑 헤어지고 누구랑 사귀는게 무슨잘못인가?잘생겼고 인성좋고 자기관리잘하는 뮤지션인건 변함없음 오랜만에 티비에 나온거보니 너무 좋았음	none	none
멋져요! 얼굴살은 안 빠지게 관리 잘 해주세요~~	none	none
멋져요~! 항상 응원하고 지지합니다^^	none	none
멍멍이 같은 소리~~책임 안 질라고 하는 거지어른이 안된 사람들!!!	personality	offensive
메니저님 확실하게 공적으로만 만나세요.	none	offensive